OOOOOOOOUOOO
OO OOO O   O
OO OOO OOO O
OO   .  OO O
O OO OO  O O
OO   O O O O
OO OOO O   O
OOXO   O.OOO
OOO  O    OO
OOOOOOOOOOOO