OOOOOOOOOO
OO  . XOOO
O OOOO OOO
U  OOO.OOO
OO O    OO
OO O OO OO
OO   OO OO
OOOOOOOOOO