OOOOOOOOOOOOOOOOOOOOOOOOOOOOOOOOOOOOOOOOOOOOOOOOOOOOOO
OOX     OO   OOOOOO      OOO    OOO     O    .   OOOOO
OOOOO O     O        OOO   .  OO OOO OO  OO OOO OOOOOO
O O   OOO O  .   OOOOOOOOO OOOOOO OOO OOO  O O       O
O OO O OO    OO          OOOOOO        O O OO O OO O O
O  OO  OOO OOOOO OOOOO O       O OO OOOO O     OO  O U
OOO O    OOOOOOO       O OOOOO   OO  .     OOO  OO  OO
OOOOOOOOOOOOOOOOOOOOOOOOOOOOOOOOOOOOOOOOOOOOOOOOOOOOOO