OOOOOOOOOOOOOOOOOOOO
O OOO OO .   OOOOOOO
O OOO OO OOO       O
O OOO O  OOO OOOOO O
O OOO   OOOO    OO O
OO    OOOOOOOOO O  O
OO OO OOO   OOO O OO
OO O    O O OOO O  O
OO O OO   OXOO   O O
OO O OOOOOOOOO OOO O
OO   OO   .    OOO O
OOOO OO OOOOOOOOOO O
OOOO OO    OO O    O
OOOO  OOO  O     OOO
OOOOOOOOOOUOOOOOOOOO